3333333333333
3411111111143
3112011111113
3114411614113
3111611611113
3111411111113
3411111111143
3333333333333