3333333333333
3411111111143
3112111111113
3112101412113
3111211111113
3111111121113
3411111111143
3333333333333