3333333333333
3411111111143
3112011111113
3114611614113
3111411611113
3111111111113
3411111111143
3333333333333