3333333333333
3411111111143
3112111111113
3114111611113
3111211161113
3111111101113
3411111111143
3333333333333