3333333333333
3411111111143
3111011111113
3114411414113
3111611211113
3111111111113
3411111111413
3333333333333